34,34,34,34,34,34,34,34,34,34
34,5,6,6,6,6,6,6,7,34
34,15,16,16,16,16,34,34,17,34
34,15,16,34,16,16,34,34,17,34
34,15,16,34,16,16,16,16,17,34
34,15,16,34,34,34,34,34,17,34
34,15,16,16,16,16,16,34,17,34
34,15,16,34,16,16,16,34,17,34
34,25,26,26,26,26,26,26,27,34
34,34,34,34,34,34,34,34,34,34
